1111111111111111111111111111111111111111
1222210222220111022200222001100110011001
1111000111110222011111100022222222222201
1221022201001111102222102200110220110201
1022222222222222201222111102201102201101
1100111122211110011110022221122011220011
1022221002222222222200111111122222112201
1001111111102011022200022222222211022221
1122210222220022011110011112221100222201
1102212211001022010000000010220122111111
1102212210221022010000000010220122222221
1001112210221022010000000010220122021111
1221222211111110011111111110220111122201
1221110222110220102201122220222222102211
1222220222000200101112222222201101120211
1221221221221222222221101112222222120211
1221221121221221221112222222222111122201
1221221121221221221112221111122222221221
1221221221001221221112221220222011221121
1002221212221221221112221010222011221121
1110022222202221222222222110222012212221
1222212212221111001111112202122222222221
1222222222222222222222220221122221122001
1111111111111111111111111111111111111111