1111111111111111111111
1000010000000111000001
1111000111110000011101
1001000001001111100001
1000000000000000001001
1100111100011110011111
1000001000000000000001
1001111111100011011101
1100010000000000000001
1100010011001100111001
1100010010000100101001
1001110010000100001001
1001000011111100111001
1001110000110000100001
1000000000000000101111
1001001001001000000001
1001001111001111001111
1001000000000000000001
1111111111111111111111